50 16
1111111111111111
1111111000000101
1100101111010101
1101101001010001
1100001101010111
1110111101010111
1110111100010001
1110101101111101
1110101101000001
1110101001011111
1100000011000011
1111111001111011
1101111101000011
1100000101011111
1101111101000011
1101111101011111
1100000101000011
1111010101111001
1111010101001011
1111010001011111
1111010101000111
1111010101110111
1100010101110111
1111010100000111
1000010101111111
1011111111111111
1010000001100001
1010111101101101
1010111101101101
1010111100001101
1010101111101001
1010100001101011
1010101101001011
1010101101011011
1010101110001011
1010101110101111
1010101110001101
1000101111011101
1111101111000001
1100000001101101
1101101111101101
1101100000001101
1101111110111101
1101111110110001
1101101110110101
1111101110110101
1110101000110101
1110101011111111
1110000011111111
1111111111111111
46 3 18 14


