16 55
1111111111111111111111111111111111111111111111111111111
1000111110000111111111011111111110000111111000000000011
1110111110110100001010000111111110110000001110111101111
1000000000110101101010111100000110111111111110111100011
1011111111110101101010101101110110000000100010000111111
1000000000110001100000100001110111101110001000110111111
1011111110111111111111111111110111101111100011110000011
1011100000000011000000000000000010001000011111010111011
1011101111111000011111111011111110111011111111010111001
1111111111111101110110000000000010111011111111010111101
1100000111000001110110111111111110110000000000000110001
1111110111111101110110000000000010111111111111011111101
1101110000000001110110111111011010000000000001011111001
1100000111111101100000111111011011111111111101000001111
1111111111111111111111111111111000000000000001111111111
1111111111111111111111111111111111111111111111111111111
3 52 1 22


